ALA="countries/Alamane.txt"
ALI="countries/Albion.txt"
BCK="countries/Buckcastle.txt"
CHY="countries/CherryClan.txt"
COT="countries/ConfederationTrotsas.txt"
CRL="countries/CrystalImperium.txt"
CUL="countries/Cult.txt"
CYE="countries/CEASEYOUREXISTANCE.txt"
EMB="countries/Ember.txt"
FLY="countries/Fillydelphia.txt"
FRI="countries/MoonStarSouth.txt"
FSH="countries/FreesideHold.txt"
HAH="countries/HappyHollow.txt"
HEB="countries/Earthborn.txt"
HEF="countries/Everfree.txt"
HFT="countries/Hoofington.txt"
HMS="countries/MoonStar.txt"
HSW="countries/Stormwing.txt"
HWG="countries/Whitegold.txt"
JTL="countries/JungleLeague.txt"
LAS="countries/LasAetherius.txt"
MSE="countries/MoonStarEast.txt"
MWC="countries/Meadowood.txt"
NEF="countries/NeighgaraFalls.txt"
NIH="countries/AcorangeHoldOut.txt"
PIE="countries/Rockville.txt"
PLF="countries/Hayseed.txt"
PLT="countries/Portland.txt"
PRT="countries/PiratesCove.txt"
SGR="countries/StalliongradRemenants.txt"
SOY="countries/Soryth.txt"
STB="countries/Stableside.txt"
SWT="countries/StormWingTerritories.txt"
SYV="countries/Severyana.txt"
THA="countries/Thestrals.txt"
TRH="countries/TwilightRangeHold.txt"
TRT="countries/Trottingham.txt"
VHT="countries/VanhooverTallTale.txt"
VII="countries/VirginIslands.txt"
WTC="countries/WhitegoldTradingCompany.txt"