Daring Do - Stableside
Shining Star - Comet Province
Sunset Shimmer - Sirius
Stylus Pen - Portland
Stars Whirl - East Yucoltan
Sweet Water - Saltmane
Cabelleron - Tenochtitlan
Copper Gearheart Cog - Spa Islands
Aouizhotil - Tonaltzintli
Jungle Trek - Iztaltl Coast
Tlatoani Acazotic Huehuetlatolli I (Light Narrative) - Ayacachtli
Cricket Chafer - Duskway
Lavendaer Berry - Kululu Forest
Golden Delicious - Baltimare
Mayor Ash Moustache - Moonlight Shore
Confederation of Comunes - Hayseed Swamps
Oli Equites - Mango Province
Apple Jack - Star Forest
Big Mac - Macintosh Hills
Silverstar - Apploosa
Sunrise Moonshadow - Central Trotsas
Thunderhooves - Meskwakia
Strongheart - Ayandi
JD Neighvis - Dodge Junction
Pine Chest - Aetherlands
Starry Plough - Waffleland
Rockefeller - Rockville
Maud - Pie Farms
Golden Harvest - Carrottop
Mayor Rokenhar - Las Pegasus
Fizzleberry - Buckcastle
Zecora - Everfree
Fluttershy - Two Sisters
Filthy Rich - Fillydelphia
Boreal BLoom - Poninsula
Rarity - Freeside
Bipen - Hollow Shades
Glorvas Swifthoof (Deer) - Mareland
Midnight Oil - Bluemenkranz
Neighsay - Kemono Fields
Luna - Manehattan
Midnight Hooves - Algonquin
Little Dark - Trotterfield
Sultan Ali - Goatasus
Trixie - Magical Plateua
Fluer De Lis - Loupia
Starlight - Albion
Dark Wing - Mirage
Caramelka Sladkaya - Zakatnie Lands
Master Yrui - Koilkyno
TSar Peter IV - Pertershoof
Madoor Stronghammer - Trottingham
Rail Road - Krupochkino
Vasiliy Pantsushenko - Marshmallow
Ratibor Svetoslavich - Zvezdopadovo
Double Diamond - Starlights Town
Victor Historia - Hoofbeat Krai
Altidiya - Stalliongrad
Sinister Serov - Zayatsk
Feather Bangs - Angelless Forest
Nestor Lunin - Baicall
Squeaky Hooves - Umbrum Cage
Crystak City Outskirts - Flash Sentry
Crystal City - Mi Amore
Central Crystal City - Sombra
Artic Lily - Agate Fields
Solid Shot - Frozen Butterfly Forest
Setting Crimson - Bitterberry Fields
Raspberry Fields - Scroup Whitemares
Soundwave - Boulderfield
Blueblood - Whinnysota
Celestia - Canterlot
Twilight - Ponydale
Soarin - CLoudsdale
Night Eye - White Tail Woods
Anon - Dragon Mountain
Coltfoalnia - Mayor Mare
Cape Acadia - Strawberry Snowflake
Vanhoover - Dust Hoover
Whitebell - Pinkie
Acornage - Fancy Pants
Twisted Tail Valley - Swift Wing
Nocturnal Valley - March Gustysnow